hello=hola
goodbye=adiós
please=por favor
thank you=gracias
yes=sí
no=no
cat=gato
dog=perro
house=casa
car=coche
tree=árbol
book=libro
water=agua
food=comida
friend=amigo
happy=feliz
sad=triste
fast=rápido
slow=lento
big=grande
small=pequeño
hot=caliente
cold=frío
sun=sol
moon=luna
star=estrella
music=música
movie=película
computer=computadora
phone=teléfono